NO  ./textures/bluestone.png

WE ./textures/greystone.png

EA ./textures/redbrick.png

F 220,100,051

SO ./textures/gomu_gomu.png

C 20, 52, 55
                                   
1111111111111111111111111111
1111100000000110000000000001                     
1011000001110000000000001111                     
1000000001 1000000000000111111111                 
111111111111000001110000000000001                 
100000000011000001110111110111111111                 
11110111111111111110000010001
1111011111111     10111010101    11111111     
1100000011011111111000001E001    10000011         
10000000000000000000000000001    11111111        
10000000000000001101010010001    
1100000111010101110001111000111                   
11110111 1110101 101111000001                     
11111111 1111111 111111111111